R 822 620
NO ./textures/eagle.xpm
SO ./textures/colorstone.xpm
WE ./textures/greystone.xpm
F 221,221,221

EA ./textures/purplestone.xpm
S ./textures/barrel.xpm

C 0,0,238

1111111111  1111111
1220000221  102000W1
12200002211110220001
12200002200000200001
12200002200000000001
12200000000000011111
12200000000000011111
10000000000000000001
10000002222222222221
11111111111111111111
