R 822 622
NO ./textures/north.xpm
SO ./textures/south.xpm
WE ./textures/west.xpm
EA ./textures/east.xpm
S ./textures/barrel.xpm

F 221,221,221
C 0,0,238

1111111111  1111111
1220000221  10200001
12200002211110200001
12200002200000200001
12200002200000000001
12200000000000011111
122N0000000000011111
10000000000000000001
10000002222222222221
11111111111111111111

